11111111111111
111111PEC11
11111111111111111
