1111111111111
1C010000000C1
1000011111001
1P0011E0000C1
100000B000001
1111111111111
