1111111111111111111111111111111111
1E0000000000000C00000C0000000B0001
101001B100100B00101001000000010101
1010010010101010001001000000010101
1P0000000C00C00000000B000B000000C1
1111111111111111111111111111111111
