1111111111111111111111111111111111
1E0000000000000C00000C0000000e0001
101001e100100e00101001000000010101
1010010010101010001001000000010101
1P0000000C00C00000000e000e000000C1
1111111111111111111111111111111111
